1694592667.280625,1694592691.615899,5,gpt-4-0613,882,706,176
1694592691.635807,1694592695.337988,7,gpt-4-0613,181,175,6
1694592695.357698,1694592696.817741,7,gpt-4-0613,381,374,7
1694592696.837084,1694592706.374284,6,gpt-4-0613,1250,1176,74
1694593900.529706,1694593904.957074,1,gpt-4-0613,555,521,34
1694593904.986242,1694593923.604834,5,gpt-4-0613,896,706,190
1694593923.620576,1694593925.41807,7,gpt-4-0613,179,173,6
1694593925.434901,1694593926.628965,7,gpt-4-0613,379,372,7
1694593926.650291,1694593936.33252,6,gpt-4-0613,1248,1174,74
1694593937.220122,1694593942.400242,7,gpt-4-0613,784,748,36
1694593942.407809,1694593943.880982,7,gpt-4-0613,182,176,6
1694593943.887266,1694593945.714243,7,gpt-4-0613,382,375,7
1694593945.719698,1694593955.521818,6,gpt-4-0613,1626,1552,74
1694593956.059468,1694593967.17818,7,gpt-4-0613,1231,1126,105
1694600051.882427,1694600054.734201,1,gpt-4-0613,531,513,18
1694600054.754197,1694600057.619087,9,gpt-4-0613,72,47,25
1694606805.292079,1694606808.653317,1,gpt-4-0613,547,519,28
1694606808.673082,1694606833.490942,5,gpt-4-0613,915,704,211
1694606833.515743,1694606834.732434,7,gpt-4-0613,181,175,6
1694606834.755785,1694606835.860952,7,gpt-4-0613,381,374,7
1694606835.867557,1694606843.868509,6,gpt-4-0613,738,677,61
1694606844.072301,1694606848.171375,7,gpt-4-0613,508,471,37
1694606848.192414,1694606849.200024,7,gpt-4-0613,195,189,6
1694606849.218878,1694606851.949769,7,gpt-4-0613,394,388,6
1694606851.968913,1694606856.772108,6,gpt-4-0613,706,657,49
1694606859.806362,1694606866.475673,7,gpt-4-0613,1678,1625,53
